,num_annotations,num_tp,num_fp,num_fn,precision,recall,fmeasure,mean_error,std_error
0,89,70,85,19,0.45161290322580644,0.7865168539325843,0.5737704918032787,0.0009204730714284923,0.006840684040653407
1,107,63,13,44,0.8289473684210527,0.5887850467289719,0.6885245901639344,0.004453082952380599,0.006397863341874927
2,108,67,50,41,0.5726495726495726,0.6203703703703703,0.5955555555555555,0.005938335805970005,0.008111477678513293
3,77,76,10,1,0.8837209302325582,0.987012987012987,0.9325153374233128,0.0017320087697369035,0.005672091617805396
4,98,96,8,2,0.9230769230769231,0.9795918367346939,0.9504950495049506,0.0028556075364581887,0.004847777354346593
5,99,98,25,1,0.7967479674796748,0.98989898989899,0.882882882882883,0.0019753343673470473,0.0075667494136564045
6,60,57,8,3,0.8769230769230769,0.95,0.912,0.001823209035087767,0.0067898166852206395
7,145,129,19,16,0.8716216216216216,0.8896551724137931,0.8805460750853241,0.0018660903565892648,0.006523007369992617
8,317,317,0,0,1.0,1.0,1.0,0.002040602205047321,0.0030056453916566953
9,100,98,0,2,1.0,0.98,0.98989898989899,0.00097922198979587,0.0038927619747281877
10,8,8,0,0,1.0,1.0,1.0,0.0037499999999999444,0.004841229182759199
11,8,8,0,0,1.0,1.0,1.0,0.0020238098750000877,0.0025115299443739495
12,32,32,0,0,1.0,1.0,1.0,0.0017602044374999768,0.002924564464260379
13,453,445,4,8,0.9910913140311804,0.9823399558498896,0.9866962305986697,0.0028096260966293534,0.0038135051897515136
14,162,124,36,38,0.775,0.7654320987654321,0.7701863354037267,0.0027704631854840018,0.008229457085996709
15,60,7,8,53,0.4666666666666667,0.11666666666666667,0.18666666666666668,0.005429219714286353,0.006917516209693042
16,680,609,186,71,0.7660377358490567,0.8955882352941177,0.8257627118644069,0.000621497713464696,0.006452073984685221
17,348,289,59,59,0.8304597701149425,0.8304597701149425,0.8304597701149425,0.0015179013529413436,0.00580177785818989
18,330,309,70,21,0.8153034300791556,0.9363636363636364,0.8716502115655853,0.001596584786407637,0.004831419478786907
19,43,43,7,0,0.86,1.0,0.924731182795699,0.004043137069767463,0.003970390018663
20,16,16,7,0,0.6956521739130435,1.0,0.8205128205128205,0.002176871374999924,0.004597355448330245
21,10,10,2,0,0.8333333333333334,1.0,0.9090909090909091,0.0018616787000000638,0.003849315089180153
22,17,17,9,0,0.6538461538461539,1.0,0.7906976744186047,0.0014752572941176504,0.003104053059929494
23,12,12,1,0,0.9230769230769231,1.0,0.9600000000000001,0.002639834166666664,0.0041080178791534075
24,18,18,6,0,0.75,1.0,0.8571428571428571,0.002750063444444432,0.005984899862773206
25,31,31,17,0,0.6458333333333334,1.0,0.7848101265822784,0.004712164903225717,0.006577056836191062
26,64,53,12,11,0.8153846153846154,0.828125,0.8217054263565892,0.007743978537735771,0.0074739077967508685
27,27,27,5,0,0.84375,1.0,0.9152542372881356,0.004982783685185228,0.004693163815461353
28,44,43,10,1,0.8113207547169812,0.9772727272727273,0.88659793814433,0.003949270104651123,0.0068549384075897125
29,48,46,11,2,0.8070175438596491,0.9583333333333334,0.8761904761904762,0.0016984625652173508,0.007139393450358249
30,37,35,6,2,0.8536585365853658,0.9459459459459459,0.8974358974358975,0.0018911570142856361,0.005176659577100656
31,61,60,0,1,1.0,0.9836065573770492,0.9917355371900827,0.0027630390500000073,0.0036783974270531796
32,32,31,0,1,1.0,0.96875,0.9841269841269841,0.0031826499032258076,0.0032410854818331414
33,67,67,1,0,0.9852941176470589,1.0,0.9925925925925926,0.00023521901492536777,0.003092932519209073
34,47,47,0,0,1.0,1.0,1.0,0.00208279106382981,0.0026147797564937294
35,26,26,0,0,1.0,1.0,1.0,0.0006837612307694248,0.0034869611341580183
36,32,32,4,0,0.8888888888888888,1.0,0.9411764705882353,-0.0009410425937499091,0.0028874191640540343
37,29,29,1,0,0.9666666666666667,1.0,0.983050847457627,0.0036773794137930074,0.003764050152409903
38,18,18,9,0,0.6666666666666666,1.0,0.8,0.00116150222222216,0.0033340492342761284
39,13,13,2,0,0.8666666666666667,1.0,0.9285714285714286,-0.0004884000769229685,0.002542058163742407
40,12,12,11,0,0.5217391304347826,1.0,0.6857142857142856,0.0036678009583333746,0.006899271612843876
41,27,27,9,0,0.75,1.0,0.8571428571428571,0.0021122034074073917,0.00441298665390572
42,20,20,2,0,0.9090909090909091,1.0,0.9523809523809523,0.004388889374999991,0.005960724049127417
43,78,64,7,14,0.9014084507042254,0.8205128205128205,0.8590604026845639,0.004649943843749971,0.00616963668277702
44,52,49,6,3,0.8909090909090909,0.9423076923076923,0.9158878504672897,0.0019322971632654597,0.00511859960472462
45,76,68,1,8,0.9855072463768116,0.8947368421052632,0.9379310344827586,0.003951914617647036,0.005445111757370923
46,17,7,4,10,0.6363636363636364,0.4117647058823529,0.5,-0.010249432571428725,0.009881552850739939
47,22,21,8,1,0.7241379310344828,0.9545454545454546,0.823529411764706,0.0011758995238096929,0.008178315534207347
48,32,24,7,8,0.7741935483870968,0.75,0.7619047619047619,0.006869803916666602,0.009911302073498569
49,18,12,11,6,0.5217391304347826,0.6666666666666666,0.5853658536585366,-0.004472788750000095,0.012408895655480178
50,64,31,5,33,0.8611111111111112,0.484375,0.62,0.00702728454838702,0.008519258282534742
51,48,41,5,7,0.8913043478260869,0.8541666666666666,0.8723404255319149,0.002503733609756052,0.005667535871087618
52,26,24,0,2,1.0,0.9230769230769231,0.9600000000000001,0.004850718666666736,0.005265561854184515
53,14,5,2,9,0.7142857142857143,0.35714285714285715,0.4761904761904762,-0.00917460280000002,0.005900375032599846
54,38,32,3,6,0.9142857142857143,0.8421052631578947,0.8767123287671234,0.012081916718750092,0.007987098607441515
55,26,26,6,0,0.8125,1.0,0.896551724137931,-0.000713413076923162,0.004889356287994875
56,23,22,6,1,0.7857142857142857,0.9565217391304348,0.8627450980392156,0.0007173784545454577,0.005490996581904271
57,23,23,9,0,0.71875,1.0,0.8363636363636363,-0.0004002756521738939,0.0055012430407342045
58,37,37,12,0,0.7551020408163265,1.0,0.8604651162790697,0.0027915675945946712,0.004045572799036943
59,37,35,6,2,0.8536585365853658,0.9459459459459459,0.8974358974358975,0.0026588925857143272,0.004047375660304433
60,58,58,1,0,0.9830508474576272,1.0,0.9914529914529915,0.00376378193103446,0.0035365439480262023
61,26,16,15,10,0.5161290322580645,0.6153846153846154,0.5614035087719298,0.0036295356874999664,0.007764592051791699
62,69,55,7,14,0.8870967741935484,0.7971014492753623,0.8396946564885496,0.0032265516363636413,0.0044907301092461495
63,51,33,3,18,0.9166666666666666,0.6470588235294118,0.7586206896551724,0.005897066393939398,0.006101983552016366
64,24,17,3,7,0.85,0.7083333333333334,0.7727272727272727,0.00604775288235313,0.005441213956816717
65,24,16,5,8,0.7619047619047619,0.6666666666666666,0.7111111111111111,0.0029237529374999127,0.007015921600354572
66,54,45,5,9,0.9,0.8333333333333334,0.8653846153846153,0.007010834466666633,0.007444282175069001
67,13,3,2,10,0.6,0.23076923076923078,0.33333333333333337,-0.0006802716666667874,0.008095523673348438
68,69,52,10,17,0.8387096774193549,0.7536231884057971,0.7938931297709925,0.004145844769230724,0.006597322168085371
69,67,56,8,11,0.875,0.835820895522388,0.8549618320610687,0.004158872366071431,0.007394946063924575
70,43,39,6,4,0.8666666666666667,0.9069767441860465,0.8863636363636364,0.0031754758974359846,0.005058563882791604
71,63,60,17,3,0.7792207792207793,0.9523809523809523,0.8571428571428571,0.0031530617083332887,0.0067785213437103
72,34,18,3,16,0.8571428571428571,0.5294117647058824,0.6545454545454545,0.00733308172222243,0.005658989271658057
73,24,11,3,13,0.7857142857142857,0.4583333333333333,0.5789473684210527,0.008365285909090702,0.00659467817636856
74,38,19,6,19,0.76,0.5,0.6031746031746031,0.0030624183684210614,0.010886704313627678
75,7,4,0,3,1.0,0.5714285714285714,0.7272727272727273,0.005249433249999935,0.004867010168605474
76,15,10,0,5,1.0,0.6666666666666666,0.8,0.0061201820000000625,0.006117117418910119
77,3,2,0,1,1.0,0.6666666666666666,0.8,0.004489796500000143,0.007482993500000035
78,28,12,4,16,0.75,0.42857142857142855,0.5454545454545454,0.00246598683333348,0.004033128467647412
79,40,38,5,2,0.8837209302325582,0.95,0.9156626506024096,0.0008133433947368368,0.0044443323277342135
80,43,39,9,4,0.8125,0.9069767441860465,0.8571428571428572,0.0025809646153846896,0.0031099327441051314
81,30,30,1,0,0.967741935483871,1.0,0.9836065573770492,0.002096750200000051,0.0033104543581007066
82,55,53,5,2,0.9137931034482759,0.9636363636363636,0.9380530973451328,0.003445428905660335,0.005544255828496241
83,44,44,6,0,0.88,1.0,0.9361702127659575,0.0023167908750000407,0.004679457674510831
84,44,41,2,3,0.9534883720930233,0.9318181818181818,0.942528735632184,0.006142912987804845,0.00570264797220421
85,40,40,1,0,0.975609756097561,1.0,0.9876543209876543,0.004861111525000103,0.0037893921375796776
86,57,54,0,3,1.0,0.9473684210526315,0.972972972972973,0.0053951462222222675,0.0035447609439302205
87,24,22,0,2,1.0,0.9166666666666666,0.9565217391304348,0.0017419093863636265,0.006154070068783359
88,35,35,0,0,1.0,1.0,1.0,0.003111759485714232,0.0033383916257212647
89,22,19,13,3,0.59375,0.8636363636363636,0.7037037037037037,-0.0012662603684210562,0.004834976503713819
90,51,42,2,9,0.9545454545454546,0.8235294117647058,0.8842105263157896,0.007950545738095293,0.0060149247818281
91,26,18,20,8,0.47368421052631576,0.6923076923076923,0.5625,0.0012421269999999015,0.012000575465287851
92,42,28,17,14,0.6222222222222222,0.6666666666666666,0.6436781609195403,-0.00037009989285701226,0.010389111917742732
93,10,9,6,1,0.6,0.9,0.7200000000000001,-0.0008994703333333002,0.007169518404099582
94,46,41,13,5,0.7592592592592593,0.8913043478260869,0.8200000000000001,0.0026292798658536145,0.006860151960165584
95,38,33,4,5,0.8918918918918919,0.868421052631579,0.88,0.005038136939394044,0.004450195444891152
96,32,32,29,0,0.5245901639344263,1.0,0.6881720430107526,0.002010700609375027,0.005569667047638612
97,20,16,5,4,0.7619047619047619,0.8,0.7804878048780488,0.004162415374999871,0.007721687626735383
98,22,21,3,1,0.875,0.9545454545454546,0.9130434782608695,0.003927762071428557,0.004201459846703977
99,11,10,4,1,0.7142857142857143,0.9090909090909091,0.8,0.003585034699999973,0.006494937808619775
100,20,20,0,0,1.0,1.0,1.0,0.0069693883500000385,0.004698838803442075
101,31,29,3,2,0.90625,0.9354838709677419,0.9206349206349206,0.005274064206896445,0.004255293416802563
102,60,60,7,0,0.8955223880597015,1.0,0.9448818897637796,0.006043840183333344,0.005059372216427838
103,22,19,11,3,0.6333333333333333,0.8636363636363636,0.7307692307692307,0.002598162578947358,0.007701491369009928
104,59,52,10,7,0.8387096774193549,0.8813559322033898,0.859504132231405,0.004998256173077023,0.005700063336761916
105,30,29,4,1,0.8787878787878788,0.9666666666666667,0.9206349206349207,0.001424662275862053,0.00580006621451968
106,38,30,6,8,0.8333333333333334,0.7894736842105263,0.8108108108108109,0.005897959733333342,0.006644296109410699
107,17,16,6,1,0.7272727272727273,0.9411764705882353,0.8205128205128205,-0.00047477287499981397,0.002840701409121557
108,31,27,7,4,0.7941176470588235,0.8709677419354839,0.8307692307692308,0.0016141770370369614,0.006247731419190634
109,58,50,13,8,0.7936507936507936,0.8620689655172413,0.8264462809917354,-0.0008195006599999319,0.005727009592530289
110,49,40,3,9,0.9302325581395349,0.8163265306122449,0.8695652173913043,0.001667800949999896,0.007607217518280442
111,40,38,15,2,0.7169811320754716,0.95,0.8172043010752688,-0.0003341682368420798,0.005246687088072545
112,56,55,6,1,0.9016393442622951,0.9821428571428571,0.9401709401709402,-0.0006920218272726355,0.004973418411388307
113,72,65,7,7,0.9027777777777778,0.9027777777777778,0.9027777777777778,0.0007001574461537857,0.004784631775393842
114,65,61,8,4,0.8840579710144928,0.9384615384615385,0.9104477611940298,0.0010445713278688842,0.006015345625558181
115,43,37,4,6,0.9024390243902439,0.8604651162790697,0.8809523809523809,-0.001370655837837832,0.004958176710881358
116,45,45,5,0,0.9,1.0,0.9473684210526316,-0.0002655575666666965,0.003652008239427764
117,77,72,7,5,0.9113924050632911,0.935064935064935,0.923076923076923,0.0009089983784721893,0.006659358769641529
118,61,57,7,4,0.890625,0.9344262295081968,0.9120000000000001,-0.0006237811842104623,0.005659586746398985
119,66,57,6,9,0.9047619047619048,0.8636363636363636,0.8837209302325582,0.0011779454210525749,0.005016895568581732
120,69,67,12,2,0.8481012658227848,0.9710144927536232,0.9054054054054054,-4.128965671640505e-05,0.004642322149491433
121,50,46,14,4,0.7666666666666667,0.92,0.8363636363636363,-0.001280932179347883,0.006350235533084095
122,43,36,13,7,0.7346938775510204,0.8372093023255814,0.782608695652174,-0.002000975902777905,0.008266386238454201
123,82,78,5,4,0.9397590361445783,0.9512195121951219,0.9454545454545454,-0.001840658852564046,0.0043833853794249585
124,48,42,13,6,0.7636363636363637,0.875,0.8155339805825242,-0.0004340779285714059,0.006196833699541692
125,88,77,9,11,0.8953488372093024,0.875,0.8850574712643678,-0.0022370934350649267,0.0073321393965203
126,54,50,8,4,0.8620689655172413,0.9259259259259259,0.8928571428571429,-0.0023068021900000063,0.005389754781826626
127,57,55,13,2,0.8088235294117647,0.9649122807017544,0.88,-0.0020603994363635894,0.0031056688947059385
128,76,64,17,12,0.7901234567901234,0.8421052631578947,0.8152866242038217,-0.0014824258046874197,0.006095745773903293
129,53,51,5,2,0.9107142857142857,0.9622641509433962,0.9357798165137615,-0.00041572138235298806,0.0056867532408231185
130,65,60,9,5,0.8695652173913043,0.9230769230769231,0.8955223880597014,-0.0021436125916666823,0.006143675884428923
131,85,74,3,11,0.961038961038961,0.8705882352941177,0.9135802469135802,0.00010464596621617994,0.006565695232306559
132,67,62,8,5,0.8857142857142857,0.9253731343283582,0.9051094890510949,-0.0004805788467742758,0.005673180132381699
133,74,68,11,6,0.8607594936708861,0.918918918918919,0.8888888888888888,-0.00041816674264702366,0.0060507007755387235
134,56,55,0,1,1.0,0.9821428571428571,0.9909909909909909,-0.0003360127272727195,0.003852740756880437
135,63,60,10,3,0.8571428571428571,0.9523809523809523,0.9022556390977443,-0.0004886616833334239,0.005639433762892963
136,76,68,11,8,0.8607594936708861,0.8947368421052632,0.8774193548387097,-0.0011034408529411173,0.006050053702448867
137,79,77,7,2,0.9166666666666666,0.9746835443037974,0.9447852760736196,-0.0013309474610389822,0.00589053639175279
138,68,64,14,4,0.8205128205128205,0.9411764705882353,0.8767123287671232,-7.174694531252501e-05,0.006561670845080599
139,72,59,5,13,0.921875,0.8194444444444444,0.8676470588235294,0.001186633271186451,0.005469439349032205
140,67,55,7,12,0.8870967741935484,0.8208955223880597,0.8527131782945736,-0.0006062663272726432,0.005781552851359653
141,59,52,11,7,0.8253968253968254,0.8813559322033898,0.8524590163934426,-0.0019767132403845826,0.006048110957303849
142,53,46,13,7,0.7796610169491526,0.8679245283018868,0.8214285714285715,-0.0014699788695652692,0.008467859965126693
143,63,54,2,9,0.9642857142857143,0.8571428571428571,0.9075630252100839,0.0007737050740740844,0.005709731763823107
144,57,50,7,7,0.8771929824561403,0.8771929824561403,0.8771929824561403,0.0025287986000001256,0.006389935327624189
145,76,64,10,12,0.8648648648648649,0.8421052631578947,0.8533333333333334,-0.0017511687109375378,0.005930052790049809
146,40,27,5,13,0.84375,0.675,0.75,-0.0014054752777778279,0.006236944132011974
147,77,70,9,7,0.8860759493670886,0.9090909090909091,0.8974358974358974,-0.001365240842857072,0.007420407929004738
148,69,62,12,7,0.8378378378378378,0.8985507246376812,0.8671328671328672,-0.0011251914758064066,0.006899384821643779
149,51,47,5,4,0.9038461538461539,0.9215686274509803,0.9126213592233009,-0.0010913295425531576,0.007406533415829058
150,65,51,4,14,0.9272727272727272,0.7846153846153846,0.8500000000000001,0.00024632131372544273,0.008496638925315459
151,77,61,3,16,0.953125,0.7922077922077922,0.8652482269503546,-0.0005726547540983055,0.004442026835229803
152,64,63,11,1,0.8513513513513513,0.984375,0.9130434782608695,-0.0019065610158730151,0.006785496987926644
153,70,45,8,25,0.8490566037735849,0.6428571428571429,0.7317073170731708,0.000780801677777771,0.008541780759270222
154,66,57,9,9,0.8636363636363636,0.8636363636363636,0.8636363636363636,-0.0013738706578946965,0.0062532582437338285
155,66,52,8,14,0.8666666666666667,0.7878787878787878,0.8253968253968254,-0.0023371267163461323,0.0064926648563049865
156,68,49,5,19,0.9074074074074074,0.7205882352941176,0.8032786885245901,0.0007513077959184013,0.007413205904668016
157,65,63,8,2,0.8873239436619719,0.9692307692307692,0.9264705882352942,0.00021182068253966402,0.007210711090293631
158,39,36,6,3,0.8571428571428571,0.9230769230769231,0.888888888888889,-1.889166666699249e-06,0.00842894562688406
159,72,60,7,12,0.8955223880597015,0.8333333333333334,0.8633093525179857,0.0008314442083333137,0.006857801004400095
160,70,69,4,1,0.9452054794520548,0.9857142857142858,0.9650349650349651,0.00037217831159422273,0.0050691675862454925
161,52,48,10,4,0.8275862068965517,0.9230769230769231,0.8727272727272727,-0.00270195521875009,0.007226730273870054
162,79,69,11,10,0.8625,0.8734177215189873,0.8679245283018868,0.0012762501014493763,0.0073873218774553814
163,71,67,17,4,0.7976190476190477,0.9436619718309859,0.8645161290322582,-0.0006853482910448066,0.007586633905984972
164,66,44,4,22,0.9166666666666666,0.6666666666666666,0.7719298245614035,-0.0020495769318180593,0.006326186900692607
165,59,46,3,13,0.9387755102040817,0.7796610169491526,0.8518518518518519,-0.0015629000434782825,0.0062025119935054055
166,66,60,14,6,0.8108108108108109,0.9090909090909091,0.8571428571428571,-0.00020086870833337678,0.006231796596559142
167,153,131,34,22,0.793939393939394,0.8562091503267973,0.8238993710691823,0.0014277064312977039,0.008521846414019927
168,141,139,13,2,0.9144736842105263,0.9858156028368794,0.9488054607508533,0.0021771975287769797,0.0044516290075128015
169,201,186,26,15,0.8773584905660378,0.9253731343283582,0.900726392251816,0.0003475732150538432,0.006687706277397375
170,98,98,27,0,0.784,1.0,0.8789237668161435,0.0009544638979592224,0.004844415893567933
171,173,166,38,7,0.8137254901960784,0.9595375722543352,0.8806366047745356,0.0022209933012048953,0.006351905206348335
172,239,214,44,25,0.8294573643410853,0.895397489539749,0.8611670020120724,0.0007427898247663666,0.007665678871803668
173,162,156,9,6,0.9454545454545454,0.9629629629629629,0.9541284403669724,0.0015955874551281852,0.00471069561324668
174,162,155,22,7,0.8757062146892656,0.9567901234567902,0.9144542772861357,0.001561700493548275,0.005971499763239928
175,106,23,25,83,0.4791666666666667,0.2169811320754717,0.29870129870129875,-0.00047126043478270976,0.014937610314689055
176,57,23,8,34,0.7419354838709677,0.40350877192982454,0.5227272727272727,-0.0017184259565219478,0.011773369095386047
177,38,37,10,1,0.7872340425531915,0.9736842105263158,0.8705882352941177,0.002595453175675731,0.005944809420009208
178,241,233,17,8,0.932,0.966804979253112,0.9490835030549899,0.001715035596566473,0.005748969419142337
179,46,45,1,1,0.9782608695652174,0.9782608695652174,0.9782608695652174,-0.0005039047333332357,0.006812196149188113
180,195,179,2,16,0.988950276243094,0.9179487179487179,0.952127659574468,0.001775041955307066,0.005684908905328684
181,69,64,19,5,0.7710843373493976,0.927536231884058,0.8421052631578948,0.0020301875937499634,0.008498479266640326
182,117,111,11,6,0.9098360655737705,0.9487179487179487,0.9288702928870294,0.0019362224054052897,0.0064103467250762195
183,95,92,10,3,0.9019607843137255,0.968421052631579,0.934010152284264,0.0018774036902173673,0.005881323052693973
184,15,3,4,12,0.42857142857142855,0.2,0.27272727272727276,0.010650038666666362,0.013895044980586694
185,43,42,7,1,0.8571428571428571,0.9767441860465116,0.9130434782608695,-0.0004913071190476874,0.006892865823549472
186,104,78,62,26,0.5571428571428572,0.75,0.639344262295082,0.00250334328205131,0.006996200421808852
187,248,228,15,20,0.9382716049382716,0.9193548387096774,0.9287169042769857,0.0003934937368421006,0.0044733238426883275
188,122,100,12,22,0.8928571428571429,0.819672131147541,0.8547008547008548,0.004045918634999946,0.008259274421981244
189,99,60,11,39,0.8450704225352113,0.6060606060606061,0.7058823529411764,0.004588435599999913,0.007866236632335509
190,58,58,2,0,0.9666666666666667,1.0,0.983050847457627,0.005049261465517222,0.004372066769727653
191,163,158,17,5,0.9028571428571428,0.9693251533742331,0.9349112426035502,0.001376187901898749,0.006201753289007952
192,94,68,4,26,0.9444444444444444,0.723404255319149,0.8192771084337349,0.0022719089963235293,0.006668166007596218
193,17,13,3,4,0.8125,0.7647058823529411,0.787878787878788,0.0010361069230769506,0.008688448219467846
194,96,95,22,1,0.811965811965812,0.9895833333333334,0.8920187793427231,0.001846998615789429,0.0057369618446171
195,63,23,13,40,0.6388888888888888,0.36507936507936506,0.4646464646464646,0.0087025537826088,0.006578444971589983
196,55,52,2,3,0.9629629629629629,0.9454545454545454,0.9541284403669724,0.002115384615384711,0.004083992419537743
197,46,41,21,5,0.6612903225806451,0.8913043478260869,0.7592592592592593,-0.00035894026829264285,0.007004767145163526
198,179,179,1,0,0.9944444444444445,1.0,0.9972144846796658,0.004586579877095031,0.004070297111292358
199,143,134,14,9,0.9054054054054054,0.9370629370629371,0.9209621993127148,0.0019378449757462594,0.00631037613955629
200,138,126,14,12,0.9,0.9130434782608695,0.9064748201438848,0.0019961849960318423,0.004985039598201966
201,125,123,38,2,0.7639751552795031,0.984,0.8601398601398601,0.0008705272520325749,0.006242790896732336
202,94,83,15,11,0.8469387755102041,0.8829787234042553,0.8645833333333334,0.0004645111777108572,0.006478476325289151
203,91,69,28,22,0.711340206185567,0.7582417582417582,0.7340425531914893,0.0031065760942028784,0.007834991443945984
204,34,12,6,22,0.6666666666666666,0.35294117647058826,0.46153846153846156,0.001972789249999942,0.005563070566691788
205,61,56,21,5,0.7272727272727273,0.9180327868852459,0.8115942028985508,-0.0009250485535714245,0.008487214085918538
206,52,46,2,6,0.9583333333333334,0.8846153846153846,0.9199999999999999,0.0045883863369566265,0.005530045138296371
207,104,101,5,3,0.9528301886792453,0.9711538461538461,0.9619047619047619,0.003565928178217842,0.004772201346669856
208,87,78,11,9,0.8764044943820225,0.896551724137931,0.8863636363636365,-0.00011948344230771325,0.006684145608982036
209,397,395,50,2,0.8876404494382022,0.9949622166246851,0.9382422802850355,0.0015052101746835275,0.0034466264589385373
210,18,2,0,16,1.0,0.1111111111111111,0.19999999999999998,-0.00037414949999892144,0.00037414949999892144
211,48,44,4,4,0.9166666666666666,0.9166666666666666,0.9166666666666666,0.0019377450227273335,0.00729821699746232
212,82,72,5,10,0.935064935064935,0.8780487804878049,0.9056603773584906,0.0030135111944444293,0.006013080406153333
213,24,21,7,3,0.75,0.875,0.8076923076923077,-0.0003390561666666239,0.005217917476592176
214,19,18,6,1,0.75,0.9473684210526315,0.8372093023255814,0.0012414967222222411,0.005172374730014457
215,30,27,2,3,0.9310344827586207,0.9,0.9152542372881356,0.0037944069074072515,0.004968526429482651
216,197,188,21,9,0.8995215311004785,0.9543147208121827,0.9261083743842364,0.0013552375026596153,0.0036520422261928994
217,86,78,2,8,0.975,0.9069767441860465,0.9397590361445783,0.002051282166666655,0.004142649360109672
218,82,81,8,1,0.9101123595505618,0.9878048780487805,0.9473684210526315,0.0012159514444444995,0.00546082660514149
219,96,94,3,2,0.9690721649484536,0.9791666666666666,0.9740932642487047,0.0024948137553192163,0.004265378416124075
220,13,10,1,3,0.9090909090909091,0.7692307692307693,0.8333333333333333,0.0021485263999999837,0.008444137177887102
221,4,4,0,0,1.0,1.0,1.0,0.0012585037499999799,0.003663710893697462
222,9,9,1,0,0.9,1.0,0.9473684210526316,-0.00011111111111108962,0.0027726619557723957
223,75,75,0,0,1.0,1.0,1.0,-0.0012256986799999503,0.002693169673986988
224,10,10,2,0,0.8333333333333334,1.0,0.9090909090909091,-3.628070000001662e-05,0.003257047271402444
225,7,7,0,0,1.0,1.0,1.0,-0.0005701324285714739,0.003933522489197032
226,14,14,5,0,0.7368421052631579,1.0,0.8484848484848484,-0.0029413664285714847,0.005858153621184801
227,31,31,0,0,1.0,1.0,1.0,0.001090630322580665,0.0033531380212571977
228,15,15,0,0,1.0,1.0,1.0,0.0006515499333333369,0.003968841019234991
229,52,51,3,1,0.9444444444444444,0.9807692307692307,0.9622641509433962,-0.00013872171568625946,0.004589449988534117
230,18,18,2,0,0.9,1.0,0.9473684210526316,0.0024628375555555385,0.0020342569856637367
231,19,17,4,2,0.8095238095238095,0.8947368421052632,0.8500000000000001,-0.002790449029411714,0.008210497425155344
232,10,8,1,2,0.8888888888888888,0.8,0.8421052631578948,-0.003353174125000063,0.0015847660890838306
233,6,6,1,0,0.8571428571428571,1.0,0.923076923076923,0.0023620563333333574,0.0023620315899940017
234,12,12,1,0,0.9230769230769231,1.0,0.9600000000000001,-0.00027777733333332724,0.003258174575475451
235,22,21,0,1,1.0,0.9545454545454546,0.9767441860465117,0.001867509380952374,0.004507999817504533
236,345,343,18,2,0.9501385041551247,0.9942028985507246,0.9716713881019831,0.00025829235131199563,0.004809939971579004
237,65,62,7,3,0.8985507246376812,0.9538461538461539,0.9253731343283582,-0.0009688386370967092,0.004454751890842291
238,37,32,2,5,0.9411764705882353,0.8648648648648649,0.9014084507042254,0.0006299607656249917,0.00603255311621844
239,47,45,7,2,0.8653846153846154,0.9574468085106383,0.9090909090909091,0.0009513736444444447,0.0043583010016326135
240,42,40,3,2,0.9302325581395349,0.9523809523809523,0.9411764705882352,-4.0815862499947454e-05,0.00401487493690466
241,42,42,0,0,1.0,1.0,1.0,8.989361904757729e-05,0.0028806648664118015
242,95,88,1,7,0.9887640449438202,0.9263157894736842,0.9565217391304348,-0.001303339017045473,0.004251583816411155
243,72,65,13,7,0.8333333333333334,0.9027777777777778,0.8666666666666667,-0.0019342399615384577,0.007683905331009388
244,26,24,4,2,0.8571428571428571,0.9230769230769231,0.888888888888889,-0.00039115645833335866,0.007136213290156414
245,124,111,41,13,0.7302631578947368,0.8951612903225806,0.8043478260869565,-0.0019292760405404412,0.008059827557931144
246,55,54,7,1,0.8852459016393442,0.9818181818181818,0.9310344827586207,-0.002288149458333338,0.00873597766406563
247,29,26,4,3,0.8666666666666667,0.896551724137931,0.8813559322033899,-0.0012066104999999805,0.005686197529872897
248,15,15,46,0,0.2459016393442623,1.0,0.3947368421052631,0.004308390466666764,0.010519264368306185
249,110,97,16,13,0.8584070796460177,0.8818181818181818,0.8699551569506726,0.0021058046649483847,0.006671539207416616
250,5,5,0,0,1.0,1.0,1.0,0.0006938775999999703,0.0016407960477982705
251,173,150,21,23,0.8771929824561403,0.8670520231213873,0.872093023255814,0.00349070326666672,0.0056600465891461635
252,51,40,2,11,0.9523809523809523,0.7843137254901961,0.8602150537634408,0.001650510587500054,0.004808867015451988
253,18,17,3,1,0.85,0.9444444444444444,0.8947368421052632,-0.0023369345294117594,0.008030911152265546
254,163,153,3,10,0.9807692307692307,0.9386503067484663,0.9592476489028212,0.0035423061601305753,0.0046734842961238185
255,32,28,6,4,0.8235294117647058,0.875,0.8484848484848485,0.002776563285714322,0.0044246411080172765
256,17,17,3,0,0.85,1.0,0.9189189189189189,-0.0008283310000000383,0.0055846075142284585
257,32,30,3,2,0.9090909090909091,0.9375,0.923076923076923,0.002348072966666706,0.005721308650977772
258,103,103,0,0,1.0,1.0,1.0,0.002848997621359164,0.003090533115045102
259,153,140,33,13,0.8092485549132948,0.9150326797385621,0.8588957055214724,0.002049967821428576,0.00696261307837983
260,162,152,18,10,0.8941176470588236,0.9382716049382716,0.9156626506024096,-0.0001895362631578834,0.005232788560248937
261,148,69,15,79,0.8214285714285714,0.46621621621621623,0.5948275862068965,0.004428505905797035,0.007889691341878174
262,182,170,21,12,0.8900523560209425,0.9340659340659341,0.9115281501340482,0.0024473791264705935,0.006201863441599499
263,209,175,24,34,0.8793969849246231,0.8373205741626795,0.8578431372549019,0.002785228725714283,0.005085855797650092
264,198,191,29,7,0.8681818181818182,0.9646464646464646,0.9138755980861245,0.0011763484083769677,0.005604486478337818
265,127,122,35,5,0.7770700636942676,0.9606299212598425,0.8591549295774649,0.0017092305245901501,0.007737539332409694
266,125,105,8,20,0.9292035398230089,0.84,0.8823529411764706,0.002853256004762039,0.005258477540245086
267,66,61,26,5,0.7011494252873564,0.9242424242424242,0.7973856209150327,0.0002890228524588561,0.007525693467573623
268,199,188,15,11,0.9261083743842364,0.9447236180904522,0.9353233830845771,0.002916666781914896,0.00586286694382844
269,157,142,31,15,0.8208092485549133,0.9044585987261147,0.8606060606060606,0.0005003833802817351,0.0066860800095805755
270,261,250,52,11,0.8278145695364238,0.9578544061302682,0.8880994671403196,0.0015693879960000095,0.006775805194776411
271,221,201,51,20,0.7976190476190477,0.9095022624434389,0.849894291754757,0.001152683574626813,0.008009399388831424
272,157,151,30,6,0.8342541436464088,0.9617834394904459,0.893491124260355,-0.000723746218543104,0.006281075248089512
273,117,84,18,33,0.8235294117647058,0.717948717948718,0.767123287671233,0.0001440180238095321,0.005603188777031912
274,115,102,15,13,0.8717948717948718,0.8869565217391304,0.8793103448275862,-0.0005583342843136257,0.006849182626767809
275,73,42,15,31,0.7368421052631579,0.5753424657534246,0.6461538461538462,0.0023393803333332467,0.00740755552509076
276,253,245,1,8,0.9959349593495935,0.9683794466403162,0.9819639278557115,0.0032037581755101742,0.0038728411532259342
277,176,166,55,10,0.751131221719457,0.9431818181818182,0.8362720403022669,0.002376718234939767,0.007483308017671157
278,214,201,17,13,0.9220183486238532,0.9392523364485982,0.9305555555555556,0.0023864805323383213,0.004521963262686222
279,334,246,16,88,0.9389312977099237,0.7365269461077845,0.825503355704698,0.0032810226016258817,0.005998823420802302
280,1103,579,57,524,0.910377358490566,0.5249320036264733,0.6658999424956873,0.003263054443436368,0.006292991043565747
281,452,319,72,133,0.8158567774936062,0.7057522123893806,0.7568208778173192,0.0017436329130094785,0.008387739751136608
282,269,144,25,125,0.8520710059171598,0.5353159851301115,0.6575342465753424,0.005021652458332366,0.005074782136522519
283,714,441,16,273,0.9649890590809628,0.6176470588235294,0.7532023911187019,0.004073945793650946,0.006694022847639815
284,185,117,53,68,0.6882352941176471,0.6324324324324324,0.6591549295774648,0.003879392380341825,0.006993362138712891
285,28,22,9,6,0.7096774193548387,0.7857142857142857,0.7457627118644068,0.0020057726818182285,0.008275976759206783
286,39,26,1,13,0.9629629629629629,0.6666666666666666,0.7878787878787878,0.00017530144230771134,0.0059141507846491624
287,21,18,9,3,0.6666666666666666,0.8571428571428571,0.75,0.0017346943888888868,0.004316043001083381
288,42,31,1,11,0.96875,0.7380952380952381,0.8378378378378379,-0.0014816028548387064,0.006279265207962976
289,49,47,8,2,0.8545454545454545,0.9591836734693877,0.9038461538461537,-0.00037921495744682815,0.005984432368751969
290,62,61,4,1,0.9384615384615385,0.9838709677419355,0.9606299212598426,0.0012893577950819192,0.004513477538204686
291,41,34,5,7,0.8717948717948718,0.8292682926829268,0.8500000000000001,0.0021852079852941234,0.007028683080379011
292,56,44,4,12,0.9166666666666666,0.7857142857142857,0.8461538461538461,0.0030393223068182432,0.006851415811562633
293,27,24,8,3,0.75,0.8888888888888888,0.8135593220338982,0.00027872314583336777,0.00440914077749088
294,31,31,5,0,0.8611111111111112,1.0,0.9253731343283582,-0.0005672586774193327,0.005823954184735192
295,63,60,11,3,0.8450704225352113,0.9523809523809523,0.8955223880597014,-0.0026137561416667006,0.0059526269446087765
296,27,26,8,1,0.7647058823529411,0.9629629629629629,0.8524590163934426,-0.0014054591153845747,0.0049923558544389965
297,61,57,11,4,0.8382352941176471,0.9344262295081968,0.8837209302325582,-0.00021541903508772448,0.006005428776959994
298,47,45,8,2,0.8490566037735849,0.9574468085106383,0.9,-0.0023371121111111152,0.006311440906966327
299,49,48,20,1,0.7058823529411765,0.9795918367346939,0.8205128205128206,-0.003744212437500172,0.007746074648461482
300,46,34,6,12,0.85,0.7391304347826086,0.7906976744186046,0.0004798590441176321,0.004899059617632738
301,44,39,11,5,0.78,0.8863636363636364,0.8297872340425532,0.00021803646153854508,0.007241453603999652
302,43,39,3,4,0.9285714285714286,0.9069767441860465,0.9176470588235294,-0.0005224136153846073,0.005232174635117584
303,46,30,7,16,0.8108108108108109,0.6521739130434783,0.7228915662650603,-0.001021919350000126,0.007580897563178237
304,45,44,13,1,0.7719298245614035,0.9777777777777777,0.8627450980392156,-0.000768655477272669,0.006255570908675697
305,52,50,8,2,0.8620689655172413,0.9615384615384616,0.9090909090909091,-0.0011365074199998942,0.004701599380704796
306,40,27,5,13,0.84375,0.675,0.75,0.0008763757592592971,0.0073803359163603435
307,35,24,13,11,0.6486486486486487,0.6857142857142857,0.6666666666666667,0.0021560850833333748,0.008756791284805908
308,37,36,14,1,0.72,0.972972972972973,0.8275862068965518,-0.0016997349583332837,0.005847996769470147
309,58,51,2,7,0.9622641509433962,0.8793103448275862,0.9189189189189189,0.0014430221666667203,0.0043156879969251175
310,37,30,11,7,0.7317073170731707,0.8108108108108109,0.7692307692307694,0.0017619053500000689,0.005135611862076692
311,59,48,11,11,0.8135593220338984,0.8135593220338984,0.8135593220338985,-0.0018277583854167205,0.006496681878779679
312,51,39,4,12,0.9069767441860465,0.7647058823529411,0.8297872340425532,-0.0033301349487178536,0.006609668415084123
313,65,65,5,0,0.9285714285714286,1.0,0.962962962962963,0.0034678184461537755,0.005703152249096571
314,78,72,6,6,0.9230769230769231,0.9230769230769231,0.9230769230769231,-0.00018896397916674684,0.004722940150433242
315,60,43,3,17,0.9347826086956522,0.7166666666666667,0.8113207547169811,-1.8192802325514374e-05,0.006079200155070048
316,67,61,16,6,0.7922077922077922,0.9104477611940298,0.8472222222222222,0.0026647711639343936,0.008281163847820726
317,50,47,0,3,1.0,0.94,0.9690721649484536,0.0026520967021276334,0.00443683661920978
318,32,20,6,12,0.7692307692307693,0.625,0.6896551724137931,0.0050011340500000084,0.007268274106408941
319,40,40,3,0,0.9302325581395349,1.0,0.963855421686747,0.0033166103999999986,0.004247800906083036
